25
1 2 0
7 29 0
11 13 0
11 25 0
11 27 0
11 31 0
12 23 0
13 3 0
15 15 0
17 7 0
17 19 0
17 30 0
18 23 0
19 1 0
19 15 0
19 25 0
22 19 0
23 29 0
25 5 0
25 19 0
25 31 0
26 21 0
29 31 0
30 25 0
33 23 0
XXXXXXXXXXXXXXXXXXXXXXXXXXXXXXXXX
X +X   X   X X       X X        X
X X X X X X XXX X XXX XXX X XXX X
X X X   X   X X X   X     X X   X
X XXXXX XXX X X XXXXX XXX X XXX X
X       X     X     X X X X X   X
XXXXX XXX X X X X X X X X X XXX X
X X     X X X   X X     X X  +X X
X XXXXXXXXX X XXXXXXX X XXXXXXX X
X   X   X   X X X   X X         X
X XXX XXXXXXXXX XXX XXX XXXXXXX X
X X       X X+        X  +X+X  +X
X XXX XXXXX XXXXXXXXX X+XXX X XXX
X X+      X   X         X X   X 
X XXXXXXX X XXX X XXXXX X X XXX X
X X            +X X     X   X X X
X X X XXXXX XXXXXXXXXXX X XXX X X
X   X X+          X+   X X   X+ X
XXX X XXXXXXX XXX XXX X+X XXXXX X
X+  X X X     X+X X     X+X     X
XXXXXXX X X X X X XXX XXX XXXXX X
XS      X X X X       X   X     X
X X XXX XXXXX XXXXX+XXXXX XXXXX X
X X   X     X                +X X
X XXXXX XXX X X X X X XXXXXXXXX X
X X X+X X   X X X X+X   X      +X
X X X XXX XXX XXXXXXX+XXX XXXXX X
X X X       X X X   X       X   X
X X XXXXXXX X X XXX XXX XXXXXXXXX
X       X X X X         X     X+X
X XXXXXXX X XXXXXXXXX XXX+XXX X X
X X X   X X       X         X X X
X X XXX X X X XXX X XXXXXXX X X X
X   X       X X        +X   X   X
XXXXXXXXXXXXXXXXXXXXXXXXXXXXXXXXX