0
XXXXXXXXXXXXXXXXXXXXXXXXXXXXXXX
  X X     X           X   X   X
X X XXX XXXXXXX X XXX X X X XXX
X X       X   X X   X   X   X X
X XXXXX X X XXX XXXXX X XXX X X
X       X     X X   X X   X   X
XXXXX X XXXXXXXXXXX X XXX X XXX
X X   X X X   X   X   X   X   X
X XXX XXX X XXX XXX XXXXXXXXX X
X           X     X X X   X   X
XXXXXXX XXX X X X XXX X XXX X X
X     X   X X X X   X   X   X X
X X XXX XXX XXXXXXX XXX XXXXX X
X X     X X X   X       X X X X
X XXX X X XXX XXX XXX XXX X X X
X   X X     X     X X X X   X X
X X XXXXX XXXXX XXX X X X XXX X
X X   X X X     X   X       X X
X XXX X XXXXXXX XXX X XXX X X X
X X X       X     X   X   X   X
XXX X XXXXXXXXX X X X XXXXXXX X
X       X X X   X X X     X   X
XXX XXXXX X X X X XXXXXXX X XXX
X X         X X X X     X X   X
X X XXXXXXX XXX XXX X X XXXXXXX
X X       X   X X   X X X   X X
X X XXXXXXXXXXX XXX XXX X XXX X
X     X X X X X X X   X     X X
XXX X X X X X X X XXXXX X X X X
X   X                   X X  SX
XXXXXXXXXXXXXXXXXXXXXXXXXXXXXXX 