0
XXXXXXXXXX
X       SX
X        X
X        X
X        X
X        X
X        X
X        X
X        X
X        X
         X
XXXXXXXXXX