0
XXXXXXXXXXXXXXXXXXXXXXXXXXXXXXX
                      X   X   X
X X XXX XX   XX X XXX X X X XXX
X X                     X   X X
X       X X XXX XXXXX X XXX X X
X       X       X         X   X
XXXXX X X X XX  XXX X X   X XXX
X                     X   X   X
X XXX XXX   XXX XXX XXX   XXX X
X                   X X   X   X
XXXX XX XXX X     XXX X XXX X X
X     X                 X   X X
X X XXX XXX XXX XXX XXX XXX X X
X X                     X X X X
X XXX X X X X XXX XXX XXX X X X
X                 X X       X X
X X XXX X X XXX XXX X X X XXX X
X X                         X X
X XXX X X XXXXX XXX X XXX X X X
X           X     X   X   X   X
XXX X XXX X X   X X X XXX XXX X
X       X   X   X X X     X   X
XXX XXX X X X   X X X  XX X XXX
X X         X           X X   X
X X XX XXXX   X XXX X X XXX XXX
X X       X   X X   X X X   X X
X X XXX   X   X XXX XXX X XXX X
X             X       X     X X
XXX X XXX     X X XXXXX X X X X
X                       X X  SX
XXXXXXXXXXXXXXXXXXXXXXXXXXXXXXX 