0
XXXXXXXXXXXXXXXXXXXXXXXXXXXXX
X   XXXXXXXXXXXXXXXXXXX   X X
  XXXX                X X X X
X XXXXXXXXXXXXXXXXXXX X X X X
X                     X X X X
XXXXXXXXXXXXXXXXXXXXX X X X X
X   XX                  X X X 
X X XX XXX XX XXXXXXXXX X X X
X X    X   XXX         X X XX
X X XX XXXXXXXXXXXXXXXX X X X
XXX XX             XXXX X X X
XXX XXXXXXXXXXXXXX XX X X X X
XXX             XX    X X X X
XXXXXX XXXXXXXX XXXXXXX X X X
XXXXXX XXXX           S X   X
XXXXXXXXXXXXXXXXXXXXXXXXXXXXX