0
XXXXXXXXXXXXXXXXXXXXXXXXXXXXXXXXXXXXXXXXX
          X X           X   X   X   X   X
X XXX X XXX X XXX XXXXXXX XXX X XXX XXX X
X X   X X X   X     X X X X   X         X
X XXXXX X XXXXXXX X X X X X XXXXX XXX XXX
X X   X X     X X X       X     X X X   X
XXX XXX X XXX X X X XXXXX XXXXXXXXX XXX X
X       X X   X   X X   X         X   X X
XXX XXXXX X XXX XXXXX X X XXX X X XXX X X
X       X X       X   X X X   X X X   X X
X X X XXX X X XXX XXX XXX XXX XXXXX XXX X
X X X   X X X X     X   X X   X X       X
XXXXX XXXXXXXXXXXXX X XXXXXXXXX XXX XXXXX
X              X         X              X
XXXXX XXXXXXX XXXXXXXXXXXXXXXXXXXXXXXXXXX
X   X   X X   X   X   X   X X     X X   X
XXX X XXXXXXX X XXXXX X XXX XXXXX X X X X
X     X   X       X       X   X X   X X X
XXXXXXX XXXXXXX X X XXX X XXX X XXXXX X X
X X       X     X   X X X   X X X   X X X
X X X X X XXXXX X XXX XXXXXXX X XXX X XXX
X   X X X       X X   X   X   X     X   X
XXX X X XXX X XXX XXX X X XXX X XXXXXXX X
X X X X X   X X   X     X X X       X X X
X XXX XXXXX X XXX XXX XXX X XXX XXX X X X
X X       X X X       X     X   X   X   X
X X XXX X XXXXX XXXXXXX XXXXX X X X X XXX
X X   X X X X   X X         X X X X X X X
X XXX XXXXX X XXX X XXX XXX X X XXX X X X
X         X     X   X   X     X   SX    X
XXXXXXXXXXXXXXXXXXXXXXXXXXXXXXXXXXXXXXXXX