0
XXXXXXX XXXXXXXXXXXXXXXXXXXXXXXXX
X                               X
X X X   X X XXX X XXX XXX X XXX X
X X X               X     X X   X
X X XXX X   XXX X  XX     X XXX X
X             X         X X X   X
XXXXX XXX X X XXX X X X X X XXX X
X       X       X X     X X   X X
X XXXX XXXX X X     X X X   XXX X
X       X   X X X   X X         X
X XXX XXXXX XXX XXX XXXXX X XXX X
X X       X X         X   X X   X
X XXX XXX X XXXX XXXX X XXX X XXX
X X       X   X         X X   X X
X X XXXXX X XXX X XXXXX X X X X X
X X                     X   X X X
X X X XX XX X XXX XXXXX X XXX X X
X   X X           X   X X   X   X
XXX X X X  XX XXX XXX X X X   X X
X   X X X     X X X   X X X     X
XXXXXXX X X X X X XXX XXX XXXXX X
X       X X X X   X   X         X
X X XXX X  XX XXX X XXXXX XXX X X
X X   X     X                 X X
X X  XX XXX X X X X X XXX XXXXX X
X X X X X   X X X X X   X X     X
X X X XXX XXX XXX XXX XXX XXXXX X
X X X       X X X   X       X   X
X X XX XXXX X X XXX XXX XXX XXXXX
X       X               X    SX X
X XXX XXX X XXX   XXX XXX XXX X X
X X X                       X X X
X X XXX X X X XXX XXXX XXXX X X X
X                       X   X   X
XXXXXXXXXXXXXXXXXXXXXXXXXXXXXXXXX 