2
6 1 -20
10 25 -1000
XXXXXXXXXXXXXXXXXXXXXXXXXXX
X                        SX
X                         X
X                         X
X                         X
X                  X      X
X+                 X      X
X                  X      X
X                  X      X
X                  X      X
                   X     +X
XXXXXXXXXXXXXXXXXXXXXXXXXXX