1
1 5 -10000
XXXXXXXXXX
XXXXX+XXXX
XXXXX XXXX
XXXXX XXXX
XXXXX XXXX
XXXXX XXXX
XXXXX XXXX
XXXXX XXXX
XXXXX XXXX
XXXXX XXXX
        SX
XXXXXXXXXX