5
6 27 -80
10 15 -20
18 11 -30
31 5 -20
32 13 -150
XXXXXXXXXXXX XXXXXXXXXXXXXXXXXXXXXX
X  X     X         X         X    X
X X XXXXX X   XXX X XXXXX XXX X X X
X         X                 X X X X
X XXXXX XXXXX  XX XXX XXXXXxXXX X X
X   X           X   X     X+X   X X
XXXXX XXX XXXXX X XXXXX X X XXXXX X
X X X X       X               X X X
X X X XXX XXX X X X XXXXXXXXXXX X X
X   X X     X X X+X X   X X     X X
X XXX XXX XXX X X X X X X XXX XXX X
X X X X     X X   X X X X     X   X
X X X XXX X X X X X XXX X XXXXXXX X
X   X X X X   X X   X X     X     X
X XXXXX XXX X X X XXX X XXX X XXX X
X     X X X X   X       X   X   X X
X X X X X X X X X XXXXXXXXX X X XXX
X X X         X       X   X   X   X
X X XXX XXX+X X XXX XXXXX XXXXXXXXX
X X   X     X   X   X X     X X   X
XXXXXXX XXXXX X XXX X X X XXX XXX X
X     X   X X X X   X X X   X     X
X XXXXX XXX X     X X XXXXX XXX X X
X     X X X   X X X     X       X X
XXX X X X X X X               X X X
X   X X X   X   X     X     X   X X
X X XXX XXX XXX X X XXX XXX XXX X X
X X     X X X X X X   X X X   X X X
XXX XXXXX X X XXX X X X X XXXXXXX X
X       X       X X X X   X X     X
XXXXXXXXX XXXXX X XXX XXXXX XXX X X
X X X+     X+  X X X   X        XXX
X X X XXX XXX XXX X X XXXXXXX X X X
X   X       X     X     X   X X X X
X XXX X XXXXX XXXXXXX XXX XXX XXX X
X X   X X X     X   X       X XS  X
X X X X X XXX XXXXX XXX XXXXXXXXX X
X   X X   X     X                 X
XXXXXXXXXXXXXXXXXXXXXXXXXXXXXXXXXXX 