10
2 7 -40
3 19 -45
9 15 -10
11 25 -10
13 3 -20
13 25 -30
15 29 -3
17 19 -15
17 27 -17
29 31 -30
XXXXXXXXXXXXXXXXXXXXXXXXXXXXXXXXX
X      X   X X       X X        X
X X X X+X X XXX X XXX XXX X XXX X
X X X   X   X X X  +X     X X   X
X XXXXXXXXX X X XXXXX XXX X XXX X
X             X     X X X X X   X
XXXXX XXX X X X X X X X X X XXX X
X X     X X X   X X     X X   X X
X XXXXXXXXX X XXXXXXX X XXXXXXX X
X   X       X X+X   X X     X   X
X XXX XXXXXXXXX XXX XXXXXXXXXXX X
X X       X X         X  +X X   X
X XXX XXXXX XXXXXXXXX X XXX X XXX
X X+      X   X         X+X   X 
X XXXXXXX X XXX X XXXXX X X XXX X
X X             X X     X   X+X X
X X X XXXXX XXXXXXXXXXX X XXX X X
X   X X           X+  X X  +X   X
XXX X XXXXXXX XXX XXX X X XXXXX X
X   X X X     X X X   X X X     X
XXXXXXX X X X X X XXX XXX XXXXX X
XS      X X X X   X   X   X     X
X X XXX XXXXX XXXXX XXXXX XXXXX X
X X   X     X                 X X
X XXXXX XXX X X X X X XXXXXXXXX X
X X X X X   X X X X X   X       X
X X X XXX XXX XXXXXXX XXX XXXXX X
X X X       X X X   X       X   X
X X XXXXXXX X X XXX XXX XXXXXXXXX
X       X X X X         X     X+X
X XXXXXXX X XXXXXXXXX XXX XXX X X
X X X   X X       X         X X X
X X XXX X X X XXX X XXXXXXX X X X
X   X       X X         X   X   X
XXXXXXXXXXXXXXXXXXXXXXXXXXXXXXXXX 